NO ./assets/bluestone.xpm
SO ./assets/colorstone.xpm
EA ./assets/greystone.xpm
WE ./assets/mossy.xpm

C 84,250,84
F 25,0,200

111111111111111
10E00100000001
10000111111111111111111111111
1000011000000000000100000001
1000001000000000000000000001
10000011000000000000010001111
1110111D111011111111110001
110000110000001      10001
100000010000001      10001
100000010000001      10001
10000000000000111111111011111111111
10000001000000100000000000000000001
100000010000001000001000000000000011111
110000110000001001110000000000110010001
111111111111111001000000000000010010001
              1111111111111111111111111